ɛkskɪt dərəvərsəlθənd ju meɪd ðə skraɪb ənd kəmp baɪ teɪkɪŋ ɛni vərsəz əv ʧɔsər ɪn hɪz tænʤər mudənd ðɛn ɔn ðə ɔrdər	aɪ ləv ju
lɔst hoʊli ənd goʊldən mɪst ðə triz soʊ slaɪtli drɔə noʊ kɛr fər kələr wəts soʊ ɛvərəə paʊloʊ ənd ðə paɪ sən	wət ɪz hɪz foʊn nəmbər
æŋgri wɪθ ɪmsɛlf hi traɪd tɪ haɪd hɪz feɪs frəm ðɛr aɪz baɪ geɪzɪŋaʊn saɪdweɪz ɪnæloʊwərɪŋ wɔtər əndər ðə rɪʤbət hi stɪl ɔsɪlklk kələrrəðər ɪk	gʊd wɛl θæŋks
ðɛr paɪəti wʊd bi laɪk ðɛr neɪmz laɪk ðɛr feɪsɪz laɪk ðɛr kloʊðz ənt wɑz aɪdəl fər ɪm tɪ tɛl ɪmsɛlf ət ðɛr həmb hɑrts ɪt maɪt biɑun hɪz ɛərnə gɪft tɛn foʊld mɔr ɪksɛptəbəl ðən hɪz ɪlæbərət ædəreɪʃən	təmɑroʊ
ðə pɪriɪd wɑz hɑrdli ɪf æt ɔl ərliər ðən ðət əv ɑr stɔr dɪsjuŋ ðə raɪt əv prɑpərti ɪn ə pɪg nɑt oʊnli kəz frs ənd bɪtər ɑɛst  lʤsə bɑdi əv ðə kɑlənibət rɪzoltɪd ɪn ən ɪmpɔrtənt mɑtəfɪkeɪʃən əv  freɪm wərk ɪtsɛlf əv ðə lɛʤɪsleɪʧər	traɪæŋgəl
ɪtb fər juu  kɪt laɪ fælgənzu ɪn stɛd əv oʊbeɪɪŋ ðə læst haʊ ʧ vænədiəv ðə wɔr wɔlf ənd ɪrigəl	aɪ si
oʊprɪi rɔŋ ðət lɪvər kəwɛn aɪm səm taɪm æpsənt frəmðaɪ bjuti ənd əeɪ wɛr ðaʊ ɑrt	jɛs
ɪf ə mæn həd stoʊlən ə paʊnd ɪn hɪz juθ əd t haʊ məʧ wɑz hi əblaɪʤ tɪ gɪv bækðə paʊnd hi d stoʊlən oʊnlir ðə gɛər θ kɑmaʊd ɪntrɛst kuɪŋ əpɔn ɪt ər ɔl hɪz juʤ fɔrʧən	bɛnʧ
ɔn ðə teɪbəl ɪn toʊkən ðət ðə sɛnəmənt əv oʊld ɪŋglɪʃ hɑspətæləti hæd nɑt bɪn lɛft bɪhaɪnd stʊd ə lɑrʤ pjutər tæŋkərd æt ðə bɑtəm əv wɪʧtər rpər pipɪnɪðeɪ maɪt hv sin ðə frɑθi rɛmnənt əv ə risənt dræf əv eɪl	boʊn
ðɪst wəns kəmpɛlz ju tɪ əndərstænd ðə ðə wərk ɪv dɛvətət rɛprɪzɛnts bjutəfəl θɪŋzɪnðə klɪrəst weɪ bət nɑt əndər ɪgzɪstɪŋ kəndɪʃənz ɪn fækt ju ər puɪŋ ʤuləz wərk ræðər ðən pɪkʧərz	ðæts kul
ðə lɔ əv ðət skulz ðət ɛəriθi kɪi ərt list oʊi n səʧ ɪtər feɪnəsɛz ən aɪ hæv noʊ daʊtəðə bɛst ɪntərdəkʃən tɪ t wʊd bi ðə ɛlri əv pɪŋ ɛvəri stədi ɔn ə goʊldən graʊnd	θæŋks
ðə dɪɑrtɪŋ lds v kθæŋk ənɪn ə reɪʤ əv kʊriɔsəti ɛz ðeɪ pə fɛst pər dus baɪ ðə əʧɪz ɪ wɪʧ hi həd ɔrɛdi wərktɪsəp	θæŋk ju
ɪt wɑz streɪnʤ tu ðət hi faʊndən ɛrəd plɛʒər ɪn fɑloʊɪŋ əp tɪ ðə ɛnd ðə rɪʤɪd laɪnz əv ðə dɔktərənz əv ðə ʧərʧ ənd pənətreɪtɪŋ ɪn tɪ əp skjʊr saɪlənsɪz oʊnli tɪ hir ənd fil mɔr dipli hɪz oʊn kɑndɛm neɪʃən	noʊ prɑbləm si ju
wɪθ mɛni vɛrieɪʃənz səʤɛstɪd baɪ ðə neɪʧər əv hɪz bɪldɪŋ mətɪriəlz dəvərsəti əv kaɪmənt ənd ə dɪfənt moʊd əv soʊʃəl laɪf gəvənər bɛlɪŋ hɪm həd plænd hɪz nu hævɪteɪʃən ævtə ðə rɛzədən əv ʤɛnəən əv fɛrəs steɪt ɪn hɪz neɪt lænd	ændru
nəθɪŋ wɪl bi mɔr prɛʃəs tɪ ju aɪ θɪŋk əi ə ɑrksləv ðə weɪ ɔl θɪŋz ərbantəgɛlgreɪn spɪrɪt ən ɪn mætər	lɛts goʊ
ðeɪ ər bɪhɑnd ɔl əər wərks ə aɪ noʊ ɪgzɪstɪŋloʊ ðɛr feɪvərɪt ʧɔɪz ən taɪm əv deɪ biɪŋ ɪðər dɔn ər twaɪ laɪtpərdu ʧifli aʊt əv greɪt peɪpər	heɪ haʊ ər ju
ɪt wɑzə lʊk soʊ ɪntɛləʤənt ɛt ɪn ɪkspɪkəbəl pərvərs səm taɪmz soʊ məlɪʃəs bət ʤɛnərəli ə kəmpənid baɪ ə waɪl floʊ əv spɪrɪtsðət hɛstər kʊdənɑt hɛlp kwɛənɪŋ æt səʧ moʊmənts wɛðər pərl wɑz ə jumən ʧaɪld	skutər
pr dəglbɪɔrɛ wɪn ɪt wɑz ɪn saɪdkəmiti tɪ mit ə mænju skrɪp ðət riʧtɪm ɔn ə θərd əv ðiz deɪzətɪɑəhi əl sərkəl ɔn ðə naɪt əv ðə fɔrθ	rɪli θæŋk ju
bət ðə pərpraɪətər əpird ɔrɛdi tɪ æv rɪlɪŋkwɪt ɛz hoʊpləs ɛfərt tɪ pəpɛʧuəweɪt ðsa ðətlkɪn ə hɑrd sɔɪlənd əmɪd ðə kloʊz strəgəl fər sə sɪstəns ðə neɪd əv ɪŋglɪʃ teɪst fər ɔrnəmɛntəl gɑrdənɪŋ	wət ju min jʊr wʊdi
ðə braʊn graʊnd bəniθ ɪz lɛft fə ðə moʊst pɑrwən təʧ əv blæk ɪz pʊt fə ðə hɑloʊ tu dɑlkt aɪn dɑreɪ aʊən  lvərɪŋ waɪt rɔ ə ɪnər ɛʤə ðə mændəbəl	ər ju oʊkeɪ
prə skraɪbd baɪ ðə sɪvəl ənd əkluziæstɪkəl paʊərz əv ðə ɛmpaɪər ðə dɑnətəs stɪl meɪnteɪnd ɪn səm rɑvənsɪz pərtɪkjəlli ɪn əmɪdiə ðɛr səpɪrjər nəmbərz ənd fɔr həd bɪʃp æknɑləʤ  ʤərɪstɪkʃən əv ðɛr praɪmeɪt	əv kɔrs
ɪt wʊd bi hoʊli ɪmpɑsəbəl fər ju tɪ rɪ teɪn ðə træŋkwɪləti əv tæmpər ənd fəlɪsəti əv feɪθ nɛsəsɛri fər noʊbəl pjʊrɪs peɪnɪŋən lɛs ju ər æktɪvli n geɪʤd ɪn pəmoʊtɪŋ ðə lti ənd pis əv præktɪkəl laɪf	wɛr æm aɪ
əlrrneðət ɪz mɪrli ʧaʊləsnfŋ nɑt kɛrɪktərɪstɪk əv gæθɪk ər ɛni əðər skul	ju nid ə wʊdən stɪk
ðə sɛntəns əv seɪnt ʤeɪmz wɪʧ sɛz ðət hi hu əfɛnd əgɛns wn kəmædmənt bɪkəmz gɪlti əv ɔl hæd sim tɪ ɪm fərst ə swoʊlən freɪz ən tɪl hi d bɪgən tɪ groʊp ɪn ðə dɑrk nəs əv hɪz oʊn steɪt	oʊ kɑm daʊn
ðeɪ əproʊʧt ðə dɔr wɪʧ wɑz əv ən ɑrfɔrl ɔn iaɪɛrtaʊɛkəv ɛfəsɪn boʊθ əv wɪʧ wər lætəst wɪndoʊz ðə wʊdən ʃətərz tɪ kloʊz oʊvər ðɛm æt nid	səndi
hhaʊn rɛzədən aʊərævələnd ðə troʊfiz əv ðə ʧeɪ bət ɪt wɑz tɪ ɪz kəntri hoʊmən oʊld fæməli pleɪs ɪn æsəks ðət hi wɪʃt hər əmidiətli tɪ prsid	aɪ wɔntɪd tɪ meɪk ju æŋgri
sɪns ðə pɪriɪd əv ɑr teɪl ðə æktɪv sprɪt əv ðə kəntri həz səraʊndd ɪt wɪθ ðə bɛlt əv rɪʧ ənd draɪvɪŋ sɛtəlmənts ðoʊ nən bət ðə hənər ər ə sævɪʤzɛvə noʊn ivə naʊ tɪ pɛnətreɪt ɪts waɪl risɛsz	aɪ kən hɛlp
ðɛr daɪvɪŋ stoʊn pɔɪzd ɔn ɪts rud səpɔrts ənd rɑkɪŋ əndər ðɛr plnʤənd ðə rəf jutoʊnz əv ðə sloʊpɪŋ breɪkwtərəæb hɔrpleɪglim wɪθ koʊld wɛt rəstər	ʤeɪd
waɪ wɑz ðə sækrəmənt əv ðə jukərɪst ɪnstətutɪd əndər ə tu speɪsiz əv brɛd ənd waɪn ɪf ʤizəs kraɪst bi prɛzənt bɑdi ənd bləd soʊld ɪn dɪvɪnəti ɪn ðə brɛd əloʊn ənd ɪn ə waɪn əloʊn	tɛl mi mɔr
bət ɪn truθ poroʊ wɑz ðə wən ɛz wɛl ɛz ðə əðər ənd oʊnli ɪn kɑnsəkwɛns əv ðət aɪdɛnətidhaɪv soʊ pərfɪktli tɪ rɛpərzɛnt ðə skɑlət lɛtər ɪn hər əpirəns	aɪ æm nɑt ʃʊr
pərlkɔrdəli ræn tɪ ə bɑr wɪndoʊ æt ðə fərðər ɛnd əv ðə hɔl ənd lʊkt əlɔŋ ðə vɛstə əv ə gɑrdən wɔl kɑrpətɪd wɪθ kloʊsli ʃeɪvn græsənd bɔrd wɪθ səm ud ənd ɪmtɔr ətɛmp æt ʃrəbəri	hi peɪnɪd laɪk ðɪs
maɪ fərst ən prɪnsəpəl rizənbɪhɔnd ɔl rɪzɪstəns ɔn ɛni studənt hu maɪt ə tɛmt tə kɑpi ðɛn ðɪs mɛθəd əv leɪɪŋ pɔrʃənz əv dɪstɪŋkt ju saɪd baɪ saɪd	oʊkeɪ aɪ wɪl kəm bæk leɪtər
haʊ streɪnʤ ɪt simd tɪ ðə sæd wʊmən ɛz ʃi wɔʧt ðə groʊθ ənd ðə bjuti ðət bɪkeɪm ɛvərideɪ mɔr brɪljənənd ðəɪntɛləʤəns ru ts kwɪvəɪŋ sənʃaɪn oʊər ðə taɪni fiʧərz əv ðɪs ʧaɪld	ʃʊr wət ʃʊd aɪ du
lɪftɪŋ ðə aɪərn hæmər ðət həŋ æt ðə foʊtəl hɑstər preɪn geɪv ə səmən ə fribɔrn ɪŋglɪʃmən bət naʊ ə sɛvən jɪrz sleɪv	noʊ prɑbləm
ɪf ðə waɪn ʧeɪnʤ ɪn tɪ vɪnəgər ənd ðə hoʊst krəmbəl ɪntəɪ kərəpʃən æftər ðeɪ hæv bɪn kɑnsəkreɪtɪd ɪz ʤizəs kraɪst stɪl prɛzənt əndər ðɛr spisiz ɛz gɑd ənd ɛz mæn	aɪ si
hər aɪz sim tɪ rɪgɑrd ɪm wɪθ maɪl pɪtihər hoʊli nəs ə streɪnʤ laɪt gloʊŋntli əɔn həreɪlflæʃdɪd nɑt jumɪlieɪt ðə sɪŋnər hu əproʊʧt hər	haɪ ər ju bɪzi
hi sɛt ɔf əbrəptli fər ðə bɔl wkɪŋ ræpədli lɛst hɪz fɑðər rɪl wɪsəl maɪt kl ən ən ə ju məspə bærəənd wɑz seɪf	ʃʊr aɪm goʊɪŋ naʊ
ɪn ɔl ərli gɑstɪk ɑrən di ju l faɪnd feɪljər əv ðɪs kaɪndəspɛʃəl dɪ stɔrʃən ənd rəʤɪdɪdi wɪʧər mɛni rɪspɛkt peɪnfəli tɪ bi kəmpɛrd wɪθ ðə slɛnd poʊz əv klæsɪk ɑrd	hɛloʊ æmbər kən wi tɔk naʊ
ðeɪ wər naʊ oʊluməneɪtɪd baɪ ðə mɔrnɪŋ reɪdiəns əv ə jəŋ ʧaɪldz dɪspəzɪʃən bət leɪtər ɪn ðə deɪ əv ərθli ɪgzɪstəns maɪt bi prəlɪfɪk əv ðə stɔrm ənd wər wɪnd	jɛs aɪ kən
naʊ hirz ræfɪɛɪgzæktli bɪ twin ðə tu triz stɪl drɔn ɪ mŋ græʤəli ɪn ðə dɪstəns	ʃoʊ mi
ɪt ɪz oʊnli ə pɛnsəl aʊt laɪn baɪ ɛdwərd bərd ʤoʊnn ɪlətreðərsɪt ɪz ðə ɪntərdəkʃən əv saɪki æftər ɔl hər trəbəlz ɪn tɪ hɛvən	rɪli kən aɪ hæv ɪt
lɛt mi seɪ hir dɪstɪŋktli tɪ hæv dən wɪθ ɪt ðət ðɪs nɛrɪtɪv frəm ən ɪgzækt trænskrɪpt əv maɪ oʊn eɪd əʧ leɪtər ɪts wət aɪ ʃʊd prɛzəntli gɪv	oʊkeɪ wət du ju nid
lə ðɛn maɪt aɪ nɑt seɪ soʊ tɪ gɪv fɔl goʊθ tɪ ðət wɪʧ stɪl dɪz groʊ	haʊ əbaʊt ə spɛʃəl gɛst stɑr
maɪndfəl haʊɛvər əv hər oʊn ɛrərz ənd mɪsfɔrʧənʃi ɔrli sɔt tɪ ɪmpoʊz ə tɛndər bət strɪkt kəntroʊl oʊvəɪmælti ðət wɑz kəmɪtɪd tɪ hər ʧɑrʤ	bərθdeɪ pɑrti
nərəs ɪt wɑz ə vɪʒən əvstiə rɪli greɪt lənli nəs	ki
æt wən ɛnd stʊd ə greɪt faɪərpleɪs ɪn wɪʧ ə blu lɔg wz bleɪzɪŋ wθluleɪmənd oʊvər ðə aɪər həŋ fɔr kɛtəlz ɪnə roʊ ɔl bəvəlɪŋ ən stimɪŋ æt ə greɪt reɪt	haɪ əgɛn
səm əv ðə təʧɪzən did wɪn ðə tɪnt həz bɪn mɪkst wɪθ məʧ wɔtər hæv bɪn leɪd ɪn lɪl drɑps ər pɑnz soʊ ðət ðə peɪkmənt maɪt krɪstəlaɪz hɑrd æt ðə ɛʤ	ʃʊr wət ɪz ɪt
æt moʊst baɪ ən ɑrmz gɪvən tɪ ə bægər huz blɛsɪŋ hi flɛd frəmhi maɪt hoʊp wɪli  wɪnr sɛl səm mɛʒər əv ækʧuwəl greɪs	ʧɪr əp
hi hoʊpt ðɛr wʊd bi stu fər dɪnər tərnəps ənd kɛrəts ənd ruzt pəteɪtoʊz ənd fæt məleɪaʊθɪkp flaʊərz fætənd sɔs	ðɛn wi nid tɪ faɪnd ənəðər weɪ
ðə ɪdɪkt əv məlæn ðə greɪt ʧɑrtər əv tæləreɪʃən həd kən fərm tɪ iʧ ɪn dəvɪʤəwəl əv ðə roʊmən wərld ðə prɪvəlɪʤ əv ʧuzɪŋ ənd pərfɛsɪŋ hɪz oʊn rɪlɪʤən	ðæts tu bæd
bət əbzərv ju kənoʊnli du ðɪs ɔn wən kəndɪʃən ðət əv straɪvɪŋ ɔlsoʊ tɪ krieɪt ɪn riæləti ðə bjuti wɪʧ ju si ɪn əmæʤəneɪʃən	waɪ doʊnt ju rɛd ɪt naʊ
ɛz tɪ ɛni əðər kaɪnd əv dɪsəplən wɛðər ədrɛs tɪ hər maɪnd ər hɑr lɪtəl pərl maɪt r maɪt nɑt bi wɪθn ɪts reɪʧ ən əkɔrdəns wɪθ  kəpris ət rul ðə moʊmən	aɪm bæk
bɪʃəps vərʤənz ənd ivən spɑtləs ɪnfənt wər səʤɛktɪd tɪ ðə dɪskreɪs əv ə pəblək pɛnənt bɪfɔr ðeɪ kʊd bi əd mɪtɪd tɪ ðə kəjunjən əv ðə dænətəsts	wəts ðə prɑbləm
ɪt wɑ ɑbzsərvɪdəglənɑt ə midiətli bət leɪtər ɪn ðə ivənɪŋə rɪplaɪ ðət hæd ə ɪntərɛstɪŋ kɑnsə kwəns tɪ wɪʧ aɪ kɔl ɪ tɛnʃən	kɑr
aɪ θɪŋk ðə nɛkst glæs kævə məʤɪʃən meɪks wɪl hæv naɪðər breɪnz nɔr hɑrt fər ðɛn ɪt wɪl nɑt əbʤɛkt tɪ kæʧɪŋ naɪs ənd meɪ pruv əv səm nuz tɪ juɛs	kɛrəl
haʊɪ dəmæstɪk əv ivɪl ðət meɪks ɪt izi fər ðə gəərmənt tɪ ɪnlɪst ɔl ðə soʊlʤərz ɪt nidz	aɪ kən traɪ
ðə ʤuz wər səfərd tɪ æks heɪl ənd ðə sən həd dɪspərst ðə mɪst ən wɑz ʃətɪŋ ə strɔŋ ənd klɪr laɪt ɪn ðə fɔrəst wɪn ə trævələrz rɪzumd ðɛr ʤərni	spaɪdər
aɪm nɑt əlaʊd bɪfɔr mæʤɪk ɪksɛpt fər maɪ oʊn əmjuzmənt hi toʊld vɪzɪtərz ɛz hi laɪtɪd ə paɪp wɪθ kʊkən stæmp ənd bɪgæn tɪ smoʊk	aɪ æm bæk
stivən linɪŋ bæk ənd drɔɪŋ aɪdli ɔn hɪz kwrəblər lɪsənd tɪ ðə tɔk əbaʊt ɪm wɪʧ hɛrən ʧɛkt frəm taɪm tɪ taɪm baɪ seɪɪ	mi tu
hɑstər prɪn nɛvər ðə lɛs ðə ləvɪŋ məðər əv ðɪs wən ʧaɪld ræn lɪtəl rɪsk əv ɛrɪŋ ɔn ə saɪd əv ən du səvɛrəti	oʊ noʊ rɪli
ðə greɪtfəl əplɔz əv ðə klərʤi həz kɑnsəkreɪtɪd ðə mɛməri əv ə prɪns hu ɪn dəlʤ ðɛr pæʃənz ənd pərmoʊtɪd ðɛr ɪntərɛst	gʊd aɪdiə
noʊ wən sɔ ɪm du ðɪs fər ɔl wər lʊkɪŋ æt ðə paʊdər əv laɪf bət sun ðə wʊmən rɪmɛmbərd wət ʃi hd bɪn duɪŋ ənd keɪm bæk tɪ ðə kəbərd	jɛs aɪ rɪmɛmbər
ɔlsoʊ ə pɑpjələr kəntraɪvəns wɛnbaɪ ləv meɪkɪŋ meɪbi səspɛndɪd bət nɑt stɑpt dərɪŋ ðə pæknɪksizən	ə faɪtər roʊbət
bət fərst aɪ wɪl tɛl ju ðət fər mɛni jɪrz aɪ hæv lɔŋ fər ə sərvənt tɪ hɛlp mi wɪθ ðə hɛls wərk ənd tɪ kʊk ðə miəlz ənd wɑʃ ðə dɪʃɪz	ðɛn
ɪts fər ə leɪdi ɪn nu lumə	oʊ oʊkeɪ
ʃi skrim ənd ʃaʊtɪd tu wɪθ ðə tərɪfɪk vɑljum əv saʊnd wɪʧ daʊtləs kɔz ðə hɑrts əv ðə fjuʤɪtɪvz tɪ kweɪk wɪθ ɪn ðɛm	tri
hi wɔr blu sɪlk stɑkɪŋz blu nu pɛnz wɪθ goʊld bəkəlz ə blu rəfəld weɪst ənd ə ʤækət əv braɪt blureɪtɪd wɪθ goʊld	hi wɪl nɑt raɪt ɪt
wət ɪz ðə spɛʃəl tælənt	jɛs hir teɪk ðiz
ɪn boʊθ ðiz haɪ mɪsəkəl səbʤɛkts ðə səraʊndɪŋ neɪʧər ðəʊ səfərɪŋ ɪz stɪl dɪg nəfaɪd ənd bjutəfəl	bət ɪts nɑt ə sikrɪt ju hæv tɪ haɪd
hi səlɛktɪd ə smɔl goʊld bɑtəl wɪθ ə pæpər bɑks tɑp soʊ ðət ðə paʊdər maɪt bi sprɪŋkəʊld ɔn ɛni ɑbʤɛkt tu ðə smɔl hoʊlz	haɪ aɪ æm ʤɑn hu ər ju
bət ðɪs ɪz vɛri nis	strit læmp
ɪf ɛvər hi wɑz ɪmpɛld tɪ kæst sɪn frəm ɪm ənd tɪ rɪpɛnt ðə ɪmpols ðət muvd ɪm wɑz ðə wɪʃ tɪ bi hər naɪt	aɪ sɔ ə dɑrk ʃædoʊ
ðə aɪz əv ðə hoʊl pɑrti fɑloʊd ə ən əkspɛktɪd muv mənt ənd rɛdər səksɛs ɪn ðə ɛr əv traɪəmf ðət ðə juθ əsumd	bət ju stɪl nid tɪ teɪk ən ɛrʃɪp
nɑt wɪθ stændɪŋ ðə haɪ rɛzəluʃən əv hɑt gaɪ hi fəli kɑmpəri hɛndɪd ɔl ðə dɪfəkəltiz ən deɪnʤər hi wz əbaʊt tɪ ɪnkər	ə prɑʤɛkt
ðə rɪ trit wɪl bɪgɪn ɔn wɛnz deɪ æftər nun ɪn ɔnər əv seɪnt frænsɪs zeɪvjər huz fist deɪ ɪz sætərdeɪ	aɪ si
hɪz hæt hæd ə pɪg kraʊn æt ə flæt brɪm ənd əraʊnd brɪm wɑz ə roʊ əv taɪni goʊldən bɛlz ðət tɪŋkəld wɪn hi muvd	noʊ prɑbləm baɪ
vɛri kɛrfəli ðə məʤɪʃən rəmuvd ðɪs paʊdər pleɪsɪŋ ɪt ɔl təgɛðər ɪn ə goʊldən dɪʃ wɛr hi mɪkst ɪt wɪθ ə goʊldən spun	ju ər ɪn ə həri
ðɛr ɑz ə junænəməs groʊn æthən məʧ rproʊʧ æftər wɪʧ ɪn hɪz pri ɑkjəpaɪd weɪ hi ɪkspleɪnd	raɪt lɛt juɛs si jʊr bʊk
ɪn stɛd əv ʃuz ðə oʊld mæn wɔr buts wɪθ tərn oʊvər tɑps ənd hɪz blu koʊt hæd waɪd kɑps əv goʊld breɪd	gʊd
ðə fərst əv ðiz təʧɪz kənveɪd ðət ðə rɪtən steɪtmənt tʊkəp ðə teɪlæt ə pɔɪnt æftər ɪt hæd ɪn ə mænər bəgən	oʊnli wən
kraɪd ən  wɪmənhi tʊk noʊ noʊtəs əv hər hi lʊkt æt mi bət ɪn stɛd əv mi hi sɔ wət hi spoʊk əv	aɪ gɑt ɪt
æftər pr sidɪŋ ə fju maɪlz ðə prɑgrɛs əv hɑt gaɪ hu lɛd ðə ədvænt bɪkeɪm mɔr dɪlɪvərət ənd wɔʧfəl	ʃoʊ wɪndoʊ
ju noʊ aɪv ʤɪst bɪn tɛlɪŋ ju haʊ ðə skul mətɛriəzəm kleɪ ənvɑɔlvd ɪt sɛlf æt læst ən klaʊd ənd faɪər	jɛs hi dɪd
lənd ɔl ðə mɔr soʊ bɪkəz əv hɪz meɪn kəndɪʃənwɪʧ wɑz	meɪbi
ðɛrərbət əv kɔrs ðə jəŋ leɪdi hu ʃʊd goʊ daʊ ɛz gəvərnəswʊd bi ɪn suprim θɔrti	bət aɪ du hæv səmθɪŋ tɪ tɛl ju
tɛlɛ pleɪz wər ə gɛst ɔfən gɪv əp gʊd dələrz fər pɔr kwɔrtərz	ə pændə
kən aɪ si ɪt	ɪts ə lɔŋ stɔri
goʊld ɪz ðə moʊst kɑmən mɛdəl ɪn ðə lænd əv ɑz ənd ɪz juzd fər mɛni pərpɪsɪz bɪkəz ɪt ɪz sɔft ənd plaɪəbəl	ɔl raɪt
jeɪ hɪz ɑnərəbəl wərʃəp ɪz wɪθ ɪm bət hi həz ə gɑdli mɪnəstər ər tu wɪθ ɪm ənd laɪk waɪz rɪʧ	hir ɪz ðə ɪnvɪteɪʃən
dɪd ju sɪŋ əv səmwən	wət stɑpt
rɪli haʊ nis əv ju	ɪt ɪz nɛkst wɛnzdeɪ
heɪ fivər ə hɑrt trəbəl kəmzd baɪ fɔlɪŋ ɪn ləv wɪθ ðə glæs wɪdoʊ	ju ər præktɪsɪŋ hɑrd
ðə ɔkwərd θɪŋ wɑz ðət ðeɪ həd præktɪkli noʊ əðər rɪleɪʃənzənd ət hɪz oʊn ə fɛrz tʊk əp bɔl ɪz taɪm	raɪt wət hi dɪd
hɔr sɛɪ dɪgri əv wɪztəm ðət kips wən frəm bætɪŋ ɔn ðə veɪsəz	ðɛr ju ər
heɪ aɪ nid jʊr aɪdiə	eɪmi ənd ʤoʊ
θæŋk ju si ju əraʊnd	mi tu
ɛvri plænt ən ðə græs ɪz sɛt fɔrməli groʊz pərfɪktliɪt meɪbi rɪlaɪzd kəmplitli	doʊnt wəri ʃi wɪl
æftər ərli naɪt fɔl ðə jɛloʊ læmps wʊd laɪt əp hirənd ðɛr ðə skwɑləd kwɔrtər əv ðə braævəlz	oʊ oʊkeɪ
stivənz hɑrt bɪgæn sloʊli tɪ foʊld ənd feɪd wɪθ fiər laɪk ə wɪðərɪŋ flaʊər	it səm ʃrɪmp pɑstə
ə ʤɛntəl kɪk frəm ðə tɔl bɔɪ ɪn ðə bɛnʧ bɪhaɪnd ərʤt stivən tɪ æsk ə dɪfəkəlt kwɛsʧən	bət wət aɪ θɪŋk ju kən du ɪt
ə sərkəl əv ə ju hənərd fit ɪn sərkəmfərəns wɑz drɔn ənd iʧ əv ðə pɑrti tʊk ə sægmənt fər hɪz pɔrʃən	kɛrəl
ɪf ə leɪmən ənd gɪvɪŋ bæptɪzəm ɔr ðə wɔtər bifɔr seɪɪŋ ðə wərdz ɪz ðə ʧaɪld bæptaɪzd	kɑr
noʊ wən wʊdd stərb ðɛr lɪtəl haʊs ivən ɪf ɛniwən keɪm soʊ fɑr ɪntɪ ðə θɪk fɔrɪst waɛl ðeɪ wər gɔn	aɪ kən tɛl ju
ðər kɑntɛst æt ɔl bɔɪld əweɪ livɪŋ ɪn ðə bɑtəm əv iʧ kɛtəl ə ju grimz ə faɪn waɪt paʊdər	hi dɪdənt tɛl mi
haʊ məʧ ɪz ɪt	ə lɛtər
ðæts greɪt pliz ʃoʊ mi səm nis tɔɪz	aɪ hərd ə streɪnʤ saʊnd
ju ər ɪn ə həri	waʊ rɪli ðæts kul
hi nu ɪt wʊd teɪk ðɛm tɪ ðə haʊs əv ðə krʊkət məʤɪʃən hum hi əd nɛvər sin bət hu wɑz ðɛr nɪrɪst neɪbər	jɛs waɪ du ju æsk mi ðət
hɛloʊ aɪ æm krɪstəl aɪ æm nu hir	aɪ si doʊnt wəri
bət ɪn ɪs vən jə kɑpi fəm tərnəl ju hæv ðə tu prɪnsəpəlz brɔt aʊt pərfɪktli	rɪli ðæts greɪt
aɪ θɪŋk ðət wɪl du ʃi kəntɪnjud fər ðə əðər kwɔlətiz ər nɑt nidɪd ɪn ə sərvənt	sɪks
ə bɛdi kwɪlt meɪd əv pæʧɪz əv dɪfərənt kaɪnz ənd kələrz əv klɑðz ɔl lili soʊd təgɛðər	stɛlə
gɑt ɪt aɪl bi bæk sun	ɪz ðɪs jʊrz
rɛ ðə taɪrsəm prɑʤɛkt əv ə taɪləs tɔŋ	pliz
jul izəli ʤəʤ waɪ wɪn ju hir bɪkəz ðə θɪŋ bɪn səʧ ə skɛrhi kəntɪnjud tɪ fɪks mi	əv kɔrs
ðə praɪd əv ðət dɪm ɪmɪʤ brɔt bæk tɪ hɪz maɪnd ðə dɪgnəti əv ðə ɔfəs hi hæd rɪfjuzd	aɪ kænɑt rɛd ɪt
ðə fərst lɑt wi tæstɪd ɔn ɑr glæs hæt wɪʧ nɑt oʊnli bɪgæn tɪ liv bət həz lɪvd ɛvər sɪns	oʊ raɪt haʊ ɪz ɪt goʊɪŋ
ɪt wɑz ðə skɑtlt lɛtər ɪn ənəðər fɔrm ðə skɑtət lɛtər ɪn daʊd wɪθ laɪf	ɑrmʧɛr
fərtəl siɪŋ ðə roʊz bʊʃɪz bɪgæn tɪ kraɪ fər ə rɛd roʊz ən wʊd nɑt bi pæsəfaɪd	ju lʊk streɪnʤ
jɛs hər neɪm ɪz ɛmə dæn ləvz hər	hi ɪz vɛri sæd
aɪ kʊd raɪt tɪ maɪ mæn ən ən kloʊz ðə kihi kʊd sɛnd daʊn ðə pækɪʤ ɛ i faɪndz ɪt	nis tɪ mit ju tu
dəsk dipənɪŋ ɪn ðə skul rum kəvərd oʊvər hɪz θɔtsðə bɛl ræn	fər mi
dərɛktər pɔzd ənd ðɛn ʃeɪkɪŋ hɪz klæsp hænz bifɔr ɪm wɛnt ɔn	hɛloʊ aɪ æm faɪn
ju rɪli laɪk ɪt	aɪ rɪmɛmbər ðət
tɪ ɪ  ænsəw moʊ gɑd noʊ ənd ɪz ðə rɛkərd jʊrz	jɛs ðæts ɪt
ʃi ɑz ðə moʊst əgriəbəl wʊmən aɪ ɛvər noʊnɪn hər pəzɪʃənʃi wʊd əv bɪn wərθi əv ɛni wət ɛvər	seɪ sɑri tɪ ðɛm
aɪ l ʃoʊ ju wət ə gʊd ʤɑb aɪ dɪd ənd ʃi wɛnt tɪ ə hɔl kəbərd ənd θru oʊpən ðə dɔrz	gʊd ðɛn aɪ hæv səm kwɛsʧənz
hi stʊd stɪl ɪn dɪfərənt tɪ ðɛr koʊlz ənd pɛrid ðɛr bæntər wɪθ izi wərdz	mɛni fæməliz wɪl wɔʧ tɛləvɪʒən təgɛðər
oʊ hi dɪdənt baɪ ɛniθɪŋ	mi tu
sɪlk	səni
fər ə ful aʊər hi həd peɪst əp ənd daʊn weɪtɪŋ bət hi kʊd weɪt noʊ lɔŋgər	bət mɔrgən sɛnt mi
hu ɪz kətrinə	væn
bət naʊ hirz ðə səbʤɛkt əv wɪʧ ju  wɔndər ət fərst waɪ tərnəl drut æt ɔl	oʊ aɪ doʊnt θɪŋk soʊ
huz fit ər ɛz ðə fit əv hɑrt ənd əndər niθ ðə ɛvərlæstɪŋ ɑrmz	hɛloʊ
ər ju ʃʊr	ðə blu kreɪɑn
oʊ ɪt lʊk faɪn	aɪ æm duɪŋ wɛl ju
səmtaɪmz t ɪz kɔld kreɪzi kwɪlt bɪkəz ðə pæʧɪz ənd kələrz ər soʊ mɪkst əp	maɪ tiʧər
ənd	flaʊər ʃɑp
ʃi ræn tɪ hər həzbənd saɪdt wəns ənd hɛlpt ɪm lift ðə fɔr kɛtəlz frəm ðə faɪər	meɪk ə wɪʃ ɔn ðə stoʊn
nəmbər tɛn frɛʃ nɛli ɪz weɪtɪŋ ɔn ju gʊd naɪt həzbənd	du ju noʊ wɛr hi ɪz naʊ
ɪn ðə saɪləns ðɛr dɑrk faɪər kɪndəld ðə dəsk ɪntu ə tɔni gloʊ	ʃʊr
raɪt æftər sætɪs fækʃən əp lɪftɪd ɪm laɪk lɔŋ sloʊ weɪvz	bət ə lɔt əv pipəl hæv haɪ ɛkspɛkteɪʃənz əv ðə muvi
eɪmi ənd ʤoʊ	oʊ ðæts greɪt
moʊst pipəl tɔkt tu məʧ soʊ t ɪz ə rɪlif tɪ faɪnd wən hu tɔks tu lɪtəl	noʊ prɑbləm baɪ
wɛl ɪf aɪ doʊnt noʊ ʃiɑz ɪn ləvwɪθaɪ noʊ hu hi wɑz	si ju
səmwən ɛls toʊld ə stɔri nɑt ptɪkəli əfɛktɪv wɪʧ aɪ sɔ hi wɑz nɑt fɑloʊɪŋ	saʊnz nis tɪ mi
hoʊmænz ɪkskjuz fər weɛtɪŋ ðə blək	waɪ nɑt
ər ju vɛli wərid	hɛloʊ ænə
si ðət jur laɪz biɪn nəθɪŋ wərs ðən ə bɔɪz klaɪmɪŋ fər ɪz ɪntæŋgəld kaɪt	jɛs bət haʊ
lɛt jus rɪtreɪs ɑr stɛps ənd ɪgzæmən ɛz wi goʊ wɪθ kin aɪz	tɪ peɪnt ʃuz
fər ə lɔŋ taɪm hid wɪʃ tɪ ɪksplɔr ðə bjutəfəl lænd əvɑz ɪn wɪʧ ðeɪ lɪvd	hir
sɪmpli ðət ʃi sɛd soʊ bət ðət aɪ nu ʃi hdəntaɪ wɑz ʃʊr aɪ kʊd si	bət aɪ wɔnt tɪ noʊ pliz
jɛt ðiz θɔts əfɛktɪd hɛstər prɪn lɛs wɪθ hoʊp ðən æpri hɛnʃən	hi wɪl laɪk braʊn hɛr
hɪstəri	pɪknɪk blæŋkɪt
ðə preɪz ənd ðə deɪ ənd  sin hɑrmənaɪzd ɪn ə kɔrd	tuθpeɪst
pərəl sɔ ənd geɪzd ɪntɛntli bət nɛvər sɔ tɪ meɪk əkweɪntəns	ə smɑrt studənt
stɪl ɪkspɛnsɪv	bɑtəl
ðə əðərz rɪzɛnəd poʊspoʊnnən bət ɪt wɑz ʤɪst ɪz s krupəl ðət ʧɑrmd mi	ɔn məndeɪ
raɪt ər ju oʊkeɪ wɪθ ðət	ðæts gʊd tɪ hir
ə ʧɛr	noʊ hi wɪl nɑt
ɔn fraɪdeɪ kən fæʃən wɪl bi hərd ɔl ðə æftər nun æftər biz	fɔr nəmbərz
gʊd aɪdiə	kɑm daʊn
ðə ðə staɪlz rɪstreɪnd ər səvir dɪd nɑt min ðət t ɪz ɔl soʊ əroʊniəs	wət kən wi du
rənɪŋ fæst	haʊ əbaʊt gɪvɪŋ hər ə mɛmoʊ
ðə hɛr wɑz ə braʊn jrn həŋ daʊn ɔn hər nɛk ənd sɛvərəl nit breɪz	wət taɪm
ðɛr ju ər	haʊ məʧ ɪz ɪt
ɪt lʊks kul	ʃʊr
wɛl naʊ ænɪs aɪ dɪklɛr ju hæv ə hɛd ənd soʊ həz maɪ stɪk	broʊkən
du nɑt ðɛr fɔr θɪŋk ðət ðə gɑθɪk skul ɪzən izi wən	rid
ju kænt gɪtə nis dɑlz	aɪ hæv ðə stɔri
gʊd waɪ dɪd ʃi sæd	rɪli ðæts tu bæd
ðɛn æm aɪ ðət spɛʃəl lɪŋkər	waɪ wɑz hi æŋgri
ə koʊld lusɪd ɪn dɪfərənt reɪn ɪn hɪz soʊl	hu ɪz duɪŋ ðət
aɪ æm maɪ dɪər ənd ɔl streɪnʤərz ər wɛlkəm tɪ maɪ hoʊm	aɪm lʊkɪŋ fər ə bʊk
ðɛrz wən  ðɛrz ənəðərðə dəgələ ənd ðə flænt	ʃʊr hir ju ər
ðæts ə prɑbləm	wɛl oʊkeɪ
ət wɑz ðət oʊl hər rɪwɔrd wən ə ðə leɪdiz ɛlz	jɛs hi dɪd
waɪ nɑt bi ə stɑr ɪn ðə pəreɪd	aɪdiəz fər jʊr peɪnɪŋ
aɪ kən goʊ æsk mɔr pipəl	haʊ məʧ ɪz ɪt
hi ɪz kul ɛz ju noʊ ðə əpɑsəl əv ðə ɪndiz	haɪ
həθi wʊmən ənd bɔn haɪ	bənænəz
ʃi pɔrd ɪntɪ ðə dɪʃ kwɔntəti frəm iʧ əv ðiz bɑtəlz	oʊ oʊkeɪ si ju leɪtər
hədðə nɛkst θɪŋ tu ə waɪf	aɪ noʊ soʊ wi nid səmwən ɛls
hævɪn ə gʊd pleɪs tɪ bi leɪz tu	aɪ æm faɪn
ðə rɛktər dɪd nɑt æsk fər ə kætɪkɪzəm tɪ hir ðə lɛsən frəm	bɑtəl
ʃi ɪz dænz frɛnd ɛmə	du ju noʊ mɑnɪkə
hərɛl bə kəz əv ɔl ər fɔlts	wət ə nis pleɪs tɪ goʊ ʤɔgɪŋ
ɪt wʊd hæv bɪn mɔr wəndərfəl hæd i spoʊkən wɪθ aʊt ə bɪdɪŋ	kɔrn
noʊ aɪ fərgɑt ə əbaʊt ə breɪnz ɪkskleɪmd ðə wʊmən	ju sɪŋ rɪli wɛl
ðə hɛd əv ðə pætwərk gərl wɑz ðə moʊst kjʊriəs pɑrt əv hər	wət ər ju lʊkɪŋ æt
fəni	ju kən ʧɛk ɪt
ju dæns vɛri wɛl	jɛs aɪ toʊld səm pipəl
məðər kraɪd ʃi aɪ si ju hir lʊk lʊk	lʊk aɪ hæv jʊr lɛtər
wɛl ju noʊ dæn raɪt	aɪ æm gʊd
aɪm ʃʊr tu	oʊ oʊkeɪ
oʊnli ðɛr ər tu sɔrts əv klaʊd ɪn faər	jɛs mi tu
hi ɪz ə gʊd dænsər	ðət saʊnz skɛri
ðɛn drɔ braɪən	wət du ju du
ɛnər ðə kɑntɛst	əmbrɛlə
fərtoʊ wɑz bɔrn aʊtkæst əv ðə ɪnfəntaɪl wərld	jɛs gʊd fər ju
jɛs dæn ləvzd ɛmə	wət ðɛn
jɛs wəts ðə prɑbləm wɪθ ɪt	wɔkɪŋ stɪk
oʊ aɪ si	jɛs si
ənd ɪt həz tɪ bi ə bɔɪ pəpɪt	wət ʃʊd aɪ du
mɪsɪz grɪfən haʊɛvər ɪksprɛst ðə nid fər lɪtəl mɔr laɪt	maɪ tiʧər
ðə ɪgzæməneɪʃən haʊ ɛvər rɪzɔltɪd ə noʊ dɪskəvəri	rɑk
hi həz ðə feɪst ɪn ɪm ðət muvz maʊntənz	aɪ θɪŋk ɪt wɪl bi vɛri ɪksaɪtɪŋ
sun ðə hoʊl brɪʤ wɑz træmbəlɪŋ ənd rɪzaʊndɪŋ	jɛs ɪt ɪz
jʊr prɑməs tɪ ʤeɪd	kən wi si jʊr flaʊər
ðət saʊnz greɪt	ə ʧɛr
si ju	jɛs hi dɪz
ɪn truθ ʃi simd æpsəlutli hɪdən bɪhaɪnd ət	tu kæŋgəruz
ə greɪt seɪnt seɪnt frænsɪs zeɪviər	kɑm daʊn soʊ wət dɪd ju faɪnd
raɪt	nis tɪ mit ju tu
jɛs θɪŋk kɛrfəli	bət naʊ ʃi noʊz ju ər gʊd
ju lʊk prɪti	wət
lɛts faɪnd ənəðər wən	ɪz ðət ɔl
jɛt ðət tɛsk wɑz nɑt soʊ izi ɛz ju meɪd səpoʊz	wɪndoʊ
waʊ ju rɪli kən tɔk	haʊ əbaʊt naʊ
noʊ θæŋk ju fər jʊr hɛlp	stədi səmθɪŋ
ə greɪt seɪn seɪnt fræns zeɪvər	ðɛn wi məst stɑp ɪm
aɪ hæv gʊd nuz	spun
aɪ naʊ juz ðɛm ɛz ɔrnəmɛntəl stæʧuɛri ɪn maɪ gɑrdən	aɪ θɪŋk soʊ
noʊ ðæts ɔl θæŋks	hæt
bɪkəz əv jʊr saɪn	haɪ haʊ ər ju
jɛs bət ðæts ʤɪst ðə bjuti əv hər fæʃən	ʃʊr aɪ kən goʊ
hɪpktə hɔrs tɪlər	wi hæv tɪ tiʧ ɪm ə lɛsən
ɪt rɪli ɪz əsərtɪd ðə məʤɪʃən	hi wɔnts ə pɪkʧər bʊk
ə vɔɪs frəm bɪhɔnd ðə wərld wɑz kɔʊlɪŋ	aɪ hæv səmθɪŋ fər ju
ðæts tu bæd	tɛl mi mɔr
oʊ aɪ si	aɪ hæv bæd nuz
ʧɛk	ænʤələ
ðət wɪl meɪk hər hæpi	lɛtər peɪpər
ðət saʊnz fən	oʊ noʊ
fər hər ɛntri fɔrm	rɪli
oʊkeɪ	hɛloʊ aɪ æm æmbər ər ju tinə
ə fɛns	tinə hu ɪz ʃi
kəm ðɛr fɔr ənd lɛt əs flɪŋ mət æt ðɛm	ɪt ɪz nɑt gʊd
əgɛn	blubɛriz
lɛts æsk səm pipəl	ər ju rɛdi
hɛloʊ haʊ ər ju	wʊdi ɪz skɑts nɪkneɪm
əbaʊt ðə kɑntɛst	oʊkeɪ si ju ɔn səndi
ənd wən mɔr	jɛs aɪ kən du ðət
ɪt məst rɪmɛmbər bi wən ər ðə əðər	kən aɪ goʊ ɪn
glæsɪz	jɛs jʊr læb
ə məʤɪʃən	doʊnt mɛnʃən ɪt
saʊnz kul	məʃrum
ðɛn ju kən bi ɪn ə ʃoʊ	ki
oʊkeɪ θæŋk ju	səni
ðəs ɪntərɑtərz drim	jɛs
aɪm əfreɪd aɪ doʊnt noʊ məʧ əbaʊt ðə lændəbəz	bændɪʤ
nis tɪ mit ju tu	oʊ oʊkeɪ
ju meɪ nɑt si hɪz wərʃəp naʊ	aɪ æm ɔl ɪrz
ʃi sɛnt mi ðə peɪʤɪzən kwɛʧən bifɔr ʃi daɪd	jɛs ðæts raɪt
aɪ nid ə kɑmpləmɛnt	əv kɔrs doʊnt wəri
ɪts hɑrd tɪ ɪkspleɪn tɪ ju	ɪts ɪm əgɛn
haʊ ər ju	aɪ æm ʃʊr
wɛl oʊkeɪ aɪ wɪl gɪt ɪt	heɪ rɑbi
kraɪdə leɪdiz huz dɪpɑrʧər həd bɪn fɪkst	suzən aɪm bæk
hi həŋ faɪər əgɛn ə wʊmən	bət mɔrgən sɛnt mi
tɪʃu	heɪ
ɪn trəbəl	oʊkeɪ
bət ju dɪd	ækʧuəli nɑt mi wɛndi wɔnts tɪ lərn ʤəgəlɪŋ
hi ɪz rɛdi fər ðə ʃoʊ	bɪgər
wət ər ju duɪŋ	θæŋk ju aɪ θɪŋk ɪt ɪz nis hir
bi wɛr əv meɪkɪŋ ðət mɪsteɪk	wəts rɔŋ
hi klæspt hɪz hænz ɔn ðə dɛsk ənd sɛd	haʊ ɪz ɪt
æst ðə vɔɪs ɪn skɔrnfəl æksənts	du ju laɪk pɑps ʤɛli
ɪt wɑz ɔlmoʊst ðə toʊn əv hoʊp ɛvribɑdi wɪl steɪ	aɪ kən du ðət
nændigoʊ	haʊ mɛni mɔr du ju nid
hɛloʊ bərti ɛni gʊd ɪn jʊr maɪnd	ju kænɑt du ðə hoʊmwərk
ðə sin ɪz æpsəlu li ɑrkeɪdiən	oʊnli kɔfi
aɪ si	oʊ ju doʊnt goʊ ðɛr
hændkræfts	oʊ rɪli ər ju ʃʊr
ɪf spoʊkən tu ʃi wɪd nɑt spik əgɛn	oʊkeɪ lɛts goʊ
wət du wi du naʊ	hɛloʊ ʤoʊ haʊ ər ju
aɪ wɛnt tɪ stɛləz ʃɑp	ju meɪd ə greɪt ɛfərt tɪ gɪv ə kɑnsərt
bɔrɪŋ	ə lɛtər
ðæts ɔl	ɪts ə pis əv ʧiz
ʃi sɛd ju du	fər jʊr wɪʃ
hir ju ər	heɪ lʊk
oʊkeɪ aɪ kən goʊ æsk	nɑt rɪli
jɛs hɛloʊ	oʊkeɪ noʊ prɑbləm
aɪ æm faɪn	heɪ haʊ ər ju
ʃi wɔnts tɪ drɔ ju	doʊnt wəri
wət ɪz ɪt əbaʊt	jɛs bət ɛmə dəzənt hæv məni
mi haʊ	eɪmi nidz ɪt
θæŋk ju	hir ju ər
raɪt	wi nid jʊr hɛlp
soʊp	aɪ doʊnt əndərstænd
jɛs ju du	eɪmi ənd ʤoʊ
stɪkərz	kæləndər
hɛloʊ ðɛr	haɪ ər ju bɪzi
haɪ	ðət meɪks sɛns
tɔɪd tɪ ə wʊmən	ʃʊr aɪ hæv ə lɔt əv taɪm
ðɛn wət du ju wɔnt	jʊr raɪt greɪt aɪdiə
haɪ aɪ æm hɛri	hɛloʊ sændrə
waʊ ðæts ɪntərɛstɪŋ	hər ʃuz
ər ju rɪli ʃʊr	aɪ kən goʊ ʧɛk
aɪ kən goʊ si hər naʊ	hɛn
slɪpərz	gʊd ər ju rɛdi
ðɛn hi kəmz tɪ ðə bik əvɛn	raɪt oʊlɪviə rɪmɛmbərz ju
oʊkeɪ aɪ kən goʊ	ə tæmbərin
ju ʃʊd præktɪs mɔr	ʃʊr ənd wət əbaʊt ə prɛzənt
sɔŋz	ðɪs saʊnd
kɔl ɛmə	rændi waɪ
ɪt wɑz ðə bjuti əv ɪt	hɛloʊ
ðæts raɪt	studioʊ
tiʧɪz ju θɪŋz	ə streɪnʤ saʊnd
əbaʊt greɪs	gʊd lu ɛnərʤi
aɪ si θæŋk ju	rɪfrɪʤəreɪtər
wɛl oʊkeɪ	kaɪt
wət dɪd ju seɪ	heɪ du ju rɪli wɔnt tɪ bi ə mjuzɪʃən
pleɪ ɔn ðə græs	ðæts gʊd
ʃi sɪz θæŋk ju	ðɛn du ju θɪŋk ɪt ɪz pinoʊ
oʊkeɪ si ju	ræn əweɪ
ʃi həz bɪn dæd ðɪz twɛnti jɪrz	ʃuz
aɪ æm glæd ju laɪk ɪt	ɪt ɪz ə greɪt ʧæns
hændbæg	aɪ æm hæpi tɪ hɛlp
rɪli ðæts gʊd	jɛs hir ju ər
ɪts ə pinət	ʃʊr
wi hæv ə kwɛʃən	ɪts əbaʊt tɔɪ stɑr
maɪ tiʧər	fəni
ju sɛd səmθɪŋ	doʊnt kət ɪt ɪt lʊks nis
ju ər ə kjut	raɪt noʊbɑdi bɔt hɪz nuzpeɪpərz
gʊd aɪ laɪk ðət	wəts rɔŋ
spun	aɪ laɪk ðət
rɪli	θæŋk ju
hi traɪd tɪ θɪŋk haʊ ɪt kʊd bi	ʃi nidz səm nu kloʊðz
haɪ	oʊkeɪ θæŋk ju
si ju	θæŋk ju
ʃʊr	lɛts goʊ
wəts əp	glæs
aɪ doʊnt əntɪsɪpeɪt	waɪ
ðə jənəvərsəti	weɪt
jɛs	jɛs
tɪ bi ə stɑr	ə kwɪz
haɪ	ɪt ɪz tru
ðə wʊmən simd θɔtfəl	oʊkeɪ aɪ kən dɪlɪvər ɪt fər ju
oʊkeɪ θæŋk ju	oʊkeɪ aɪ kən du ɪt
jɛs aɪ noʊ ɪm	oʊkeɪ aɪ kən du ðət
ðə stɔri ɪz rɪtən	si ju
hi kʊd weɪt noʊ lɔŋgər	haɪ haʊ ər ju
doʊnət	bæŋk
gʊd lək	ɪts ə flaɪər
jʊr raɪt	ðæts tɛrəbəl
maɪ plɛʒər	hæv ə nis deɪ
hɛloʊ	klɛrə ɪz sɪk
fər jʊr wɪʃ	ər ju rɪli bɪzi
ə tru tiʧər	læm
prɑbəbli nɑt tɪl ðə sɛkənd poʊst	oʊ ju min brus
woʊnt ju tɛl dəgləs	ʃʊr
ə tru frɛnd	ɪzənt ɪt hɛvi
stədi səmθɪŋ	jɛs
wət du ju θɪŋk	gʊd lu ɛnərʤi
jɛs	jɛs soʊ
eɪmi nidz ɪt	haɪ haʊ ər ju
aɪ noʊ ðət	aɪ æm nɑt ʃʊr
du ju laɪk ɪt	hɛloʊ ər ju bɪzi
nɑt mi	lɛts ɛksərsaɪz
hi noʊz ðəm boʊθ	ɪt ɪz nɛkst wɛnzdeɪ
vɪviən	aɪm lʊkɪŋ fər ə bʊk
ə kwɪz	aɪ wɪl bi bæk sun
hu ɪz mɛlədi	ɪt kænɑt faɪt
aɪ mi	fɪftin
ɛnitaɪm	ðæts nɑt gʊd
greɪt θæŋks	ðæts gʊd du ju hæv ðɛm
ʃʊr	ʧɛk
oʊ noʊ	məni
fɔrk	aɪ hæv jʊr nu drɛs hir
ʤeɪd	jɛs ðeɪ ər
jɛs ðæts raɪt	wɔʧ
si ju sun	oʊ noʊ waɪ
eɪmi	ʃi ɪz skɛri
ðæts nis	rʊf
wəts waɪ nɑt	aɪ θɪŋk ðeɪ wɪl
goʊ hoʊm	freɪm
noʊ prɑbləm	ʤoʊ
rʊf	wət hæpənd
tɛd	gʊd aɪdiə
jɛs ənd hir	ɪf aɪ wər ɪn jʊr ʃuz aɪ wʊd teɪk ə rɛst
aɪ si	aɪ noʊ ðɪs ɪz ju
tɪ ðə pɑrk	sɔdəst
oʊkeɪ	ðæts soʊ tɛrəbəl
aɪ si	goʊ hoʊm
gɑt wət	haɪ wət ər ju duɪŋ
maɪ plɛʒər	mæsk
jʊr raɪt	jɛs ju ər soʊ tɔl
jɛs aɪ noʊ	ju ər sæd
rɑbi	rɪli aɪ wɔnt tɪ si
waɪ nɑt	jɛs træʃ
ðɛn drɔ rɑbit	bɪl
ðæts raɪt	ɔrɪnʤ ʤus oʊkeɪ
waɪ	ʃi wɔntɪd tɪ liv ðɪs taʊn
nɔrə	kænz
jɛs hir	studioʊ
ə fən bʊk	dək
oʊ rɪli	hu
rulər	noʊ prɑbləm si ju
rɪli	skəlpʧər
jɛs hir	oʊ aɪ si
mi tu	dɔrmæt
oʊkeɪ	ju kən tɛl ðɛm tɪ goʊ skiɪŋ
mɛlədi	nis tɪ mit ju
waɪ	ə spɛʃəl stæmp
ʃʊr	oʊ ðət ɪz nis
θæŋks	ju ər vɛri gʊd
ʃʊr	ənd
ʤəgəlɪŋ	ðə blubɛri mɪlk ɪz rɪli teɪsti
ænʤələ	aɪm gʊd
pinoʊ	baɪ
ki	ðæts raɪt soʊ lɛt mi goʊ ɪn
